ARE	AA R
ARE(2)	ER
AT	AE T
BE	B IY
CAT	K AE T
COME	K AH M
HELLO	HH AH L OW
HELLO(2)	HH EH L OW
HERE	HH IY R
HOW	HH AW
KITTEN	K IH T AH N
LOOK	L UH K
MARS	M AA R Z
ME	M IY
MIMI	M IY M IY
QUIET	K W AY AH T
RELAX	R IH L AE K S
RELAX(2)	R IY L AE K S
RUN	R AH N
SIT	S IH T
STOP	S T AA P
TURN	T ER N
WALK	W AO K
WALK(2)	W AA K
YOU	Y UW
